var -> var
False -> Pantasqa
await -> suyay
else -> manachayqa
include | import -> winasqa
pass -> pasay
None -> mana imapas
break -> pakiy
in -> en
raise -> huqariy
False -> yanqa
True -> chiqap
class -> clase
finally -> tukukuypaq
is -> es
return -> kutichiy
and -> y
continue -> hinalla
for -> para
lambda -> lambda
try -> kallpachakuy
as -> hina
def -> nisqa
from -> manta
nonlocal -> mana llaqtayuq
while -> mientras
assert -> afirmar
global -> tukuy_pachapaq
not -> mana
with -> con
async -> nisqa
elif -> mana chayqa
if -> sichus
or -> icha
yield -> panpa